1 1 1 1 1 1 1 1 1 1 1 1 1 1 1 1 1 1 1 1
1 0 0 0 0 0 0 0 0 0 0 0 0 0 0 0 0 0 0 1
1 0 0 0 0 0 0 0 0 0 0 0 0 0 0 0 0 0 0 1
1 0 2 2 2 2 2 0 0 2 2 2 2 2 0 2 2 2 0 1
1 0 2 2 2 2 2 0 0 2 2 2 2 2 0 2 2 2 0 1
1 0 0 0 0 0 0 0 0 0 0 0 0 0 0 0 0 0 0 1
1 0 0 0 0 0 0 4 0 0 0 0 0 0 0 0 0 0 0 1
1 0 0 2 2 2 2 2 0 2 2 2 2 2 0 2 2 2 0 1
1 0 0 2 2 2 2 2 0 2 2 2 2 2 0 2 2 2 0 1
1 0 0 0 0 0 0 0 0 0 0 0 0 0 0 0 0 0 0 1
1 0 0 0 0 0 0 0 7 7 7 0 0 0 0 0 0 0 0 1
1 0 0 2 2 2 2 2 0 2 2 2 2 2 0 2 2 2 0 1
1 0 0 2 2 2 2 2 0 2 2 2 2 2 0 2 2 2 0 1
1 0 8 8 8 8 8 8 8 8 8 8 8 8 8 8 8 8 0 1
1 0 8 8 8 8 8 8 8 8 8 8 8 8 8 8 8 8 0 1
1 0 0 0 0 0 0 0 0 0 0 0 0 0 0 0 0 10 0 1
1 0 0 0 0 0 0 0 0 9 9 9 0 0 0 0 0 0 0 1
1 0 0 2 2 2 2 2 0 2 2 2 2 2 0 2 2 2 0 1
1 0 0 2 2 2 2 2 0 2 2 2 2 2 0 2 2 2 0 1
1 0 0 0 0 0 0 0 0 0 0 0 0 0 0 0 0 0 0 1
1 0 0 0 0 0 0 0 0 0 0 0 0 0 0 0 0 0 0 1
1 0 0 2 2 2 2 2 0 2 2 2 2 2 0 2 2 2 0 1
1 0 0 2 2 2 2 2 0 2 2 2 2 2 0 2 2 2 0 1
1 0 0 0 0 0 0 0 0 0 0 0 0 0 0 0 0 0 0 1
1 0 0 0 0 0 0 4 0 0 0 0 0 0 0 0 0 0 0 1
1 0 0 2 2 2 2 2 0 2 2 2 2 2 0 2 2 2 0 1
1 0 0 2 2 2 2 2 0 2 2 2 2 2 0 2 2 2 0 1
1 0 0 0 0 0 0 0 0 0 0 0 0 0 0 0 0 0 0 1
1 0 0 0 0 0 0 0 7 7 7 0 0 0 0 0 0 0 0 1
1 0 0 2 2 2 2 2 0 2 2 2 2 2 0 2 2 2 0 1
1 0 0 2 2 2 2 2 0 2 2 2 2 2 0 2 2 2 0 1
1 0 8 8 8 8 8 8 8 8 8 8 8 8 8 8 8 8 0 1
1 0 8 8 8 8 8 8 8 8 8 8 8 8 8 8 8 8 0 1
1 0 0 0 0 0 0 0 0 0 0 0 0 0 0 0 0 0 0 1
1 0 0 0 0 0 0 0 0 0 0 0 0 0 0 0 0 0 0 1
1 0 0 2 2 2 2 2 0 2 2 2 2 2 0 2 2 2 0 1
1 0 0 2 2 2 2 2 0 2 2 2 2 2 0 2 2 2 0 1
1 3 3 3 3 3 3 3 3 3 3 3 3 3 3 3 3 3 3 1
1 3 3 3 3 3 3 3 3 3 3 3 3 3 3 3 3 3 3 1
1 1 1 1 1 1 1 1 1 1 1 1 1 1 1 1 1 1 1 1
